11111111111111111111111111111111111111111111111111111111
1P                      1       1         1     M      1
11111111111   H  m      1       1         1 H     1    1
1 o     w 1                 w                     1    1
1         1             1   o   1         1       1 o  1
1  M    M 1             1m     H1         1 m   M 1  M 1
1111   1111             1111 1111         1111 111111111
1                                                      1
1  w            M  o  M        M     w                 1
111111111111111111111111111111111111111111111111111    1
111111111111111111111111111111111111111111111111111    1
1                                                 1    1
1  w   M                       M        m   w   H 1    1
1  o                         1111111111111111111111    1
1       H  m                                           1
1111111111111111                  1 w 1              M 1
1              1                  1   1                1
1   M     M    1                  1 o 1                1
1                                 1   1                1
1 B                               1 w 1   M            1
1                                 1   1                1
1   M     M    1                  1 o 1                1
1              1                  1   1                1
11111111111111111111111111111111111111111111111111111111